11111111111111111
10000111000100011
1100C1E0C00100001
11100000000100001
10100000000000001
10X0X000000100001
1000010000P100001
110111111X01X0001
11111111111111111