


11111111111111111
1C000000000X0C011
1100C000C000000C1
11100000000000001
1C10010X100010101
10X0X0000C00C0001
100000E000P000001
11C111111X00X0001
11111111111111111


