1111111111111111111111111111111111
1E000000000000XC00000C000000000001
1010010100100000101001000000010101
1010010010101010001001000X00010101
1P0000000C0XC000000000000X000000C1
1111111111111111111111111111111111